XXXXXXXXXXXXXXXXXXXXXXXXXXXXXXXXXXXXXXXXX
P   X           X                     X X
X XXX XXX XXXXX X X XXXXXXXXXXXXXXXXX X X
X       X X   X X X               X X   X
X XXXXXXX X X X X XXXXXXXXXXXXXXX X XXX X
X X     X   X X X     X     X   X X     X
X X XXX XXXXX X XXXXX XXX XXX X X XXXXX X
X X   X       X   X X   X X   X X     X X
X XXX XXXXXXXXXXX X XXX X X XXX XXXXX X X
X   X X   X         X X X     X   X X X X
XXX X X X XXXXXXXXX X X X XXXXX X X X XXX
X   X   X         X   X X X     X   X X X
X XXXXXXXXXXXXXXX XXXXX X X XXXXXXX X X X
X X             X X     X X X   X X X   X
X XXXXXXXXXXX XXX X XXXXXXX X X X X XXXXX
X       X     X   X   X     X X X     X X
XXXXXXX X XXX X XXXXX X XXXXX X XXXXX X X
X X     X   X X     X X       X     X   X
X X XXXXXXX XXXXX X X XXX XXXXXXXXX XXXXX
X         X X     X X   X X   X     X   X
X XXXXXXX X X XXX XXXXX XXX X X X XXX X X
X X     X   X   X X   X   X X   X X   X X
X X XXX XXXXXXX XXX X XXX X XXXXXXX XXX X
X X   X         X   X X   X   X     X   X
X XXX XXXXX XXXXX XXX X XXXXX X XXXXX XXX
X   X     X X   X X X X     X   X   X   X
X XXXXXXX X X X X X X XXXXX X XXXXX XXX X
X X       X X X   X X   X   X X       X X
X X XXXXXXX X XXXXX XXX X XXX XXX XXXXX X
X X       X X   X     X   X X   X X   X X
XXXXX XXX X XXX XXX XXXXXXX XXX X X X X X
X   X X   X   X   X     X     X X X X   X
X X XXX XXXXX XXX XXX X X XXX X X X XXX X
X X X   X       X     X X   X     X X   X
X X X XXXXXXXXXXXXXXXXX XXXXXXXXXXX XXXXX
X X X X     X     X   X     X     X     X
X X X X XXX X XXX X X XXXXX X XXX X XXX X
X X   X X   X X X X X X   X X X X X X   X
X XXXXX X XXX X X X X X X X X X X XXX X X
X       X       X   X   X     X       X K
XXXXXXXXXXXXXXXXXXXXXXXXXXXXXXXXXXXXXXXXX
