XXXXXXXXXXXXXXXXXXXXXXXXXXXXXXXXXXXXXXXXXXXXXXXXXXXXXXXXXXXXXXXXXXXXXXXXXXXXXXXXXXXXXXXXXXXXXXXXXXXXX
P X         X         X     X   X X             X           X       X   X           X             X X
X X X XXXXX X XXXXX X XXX X X X X X XXXXXXXXX XXX X X XXXXX XXXXX X X X X XXXXX XXXXX XXX XXXXXXX X X
X   X   X       X   X     X   X   X   X   X   X   X X X   X       X X X X   X   X     X   X     X X X
X XXXXX X XXXXXXX XXXXXXX XXXXXXXXXXX X XXX XXX XXX X X X XXXXXXXXX X X X XXX X X XXX X XXX X XXX X X
X X   X           X     X X           X   X   X X X X X X   X       X X X X   X X X     X   X X   X X
X X X X XXXXXXXXXXX XXXXX X XXXXXXXXXXXXX XXX X X X XXX XXX XXXXXXX X XXX X XXXXX X XXXXX XXX X XXX X
X X X X X   X       X     X   X         X   X   X X X   X X       X X     X X     X   X   X X   X   X
X XXX X X X X XXXXX X XXXXXXX X XXXXXXX XXX XXXXX X X XXX XXXXXXX X X XXXXX X XXXXXXX XXX X XXXXX X X
X     X X X   X   X   X X     X     X       X     X X           X X X     X   X     X   X   X     X X
XXXXXXX XXXXX X X XXXXX X XXXXXXX X X XXXXX X X X X XXXXXXXXXXX X X XXXXXXX XXX XXX XXX XXX XXX XXX X
X     X     X X X       X X     X X     X X X X X X           X X X   X   X   X X     X   X X   X   X
X XXX XXXXX X XXXXX XXXXX X X X XXX XXX X X XXX X XXXXXXXXXXX X X XXX X X XXX X XXXXXXXXX X X XXX XXX
X X X       X X   X   X   X X X   X   X X   X   X X     X   X   X X   X X   X           X X   X   X X
X X XXXXXXXXX X X XXX X XXX X XXX XXXXX X XXX XXX XXX XXX X XXXXX X XXX XXX XXX X XXXXX X XXXXX XXX X
X X       X   X X X   X X   X   X     X X     X X X   X   X       X     X X   X X X   X   X   X     X
X X XXXXXXX XXX X X X X XXX XXX XXXXX X XXXXXXX X X X X XXXXXXXXXXXXXXXXX XXX XXX X X XXXXX X XXXXX X
X X         X   X   X X   X X   X X   X     X       X X     X               X   X X X     X X X   X X
X XXX XXXXXXXXX XXXXX XXX X X XXX X XXXXXXX XXXXXXXXXXXXXXX XXX X XXXXXXXXXXXXX X X XXXXX X XXX X X X
X   X X         X X   X   X X   X         X     X         X   X X   X   X     X X X     X   X   X X X
X X X X X XXXXXXX X XXX XXXXXXX XXXXXXXXX X XXX X XXXXXXX XXX X XXX X X X XXX X X XXX X XXXXX XXX X X
X X X X X   X       X X       X X   X     X X   X X     X X   X   X   X     X X X   X X   X   X X   X
X X X XXXXX XXX XXXXX XXXXXXX X X X XXX XXX X XXX XXX X X X XXXXXXXXXXXXXXX X X X X XXX X X XXX XXXXX
X X X X   X   X   X   X         X X   X   X X   X   X X   X   X           X X   X X   X X   X X     X
XXX X X X XXX XXX XXX X XXXXXXXXX XXX XXX XXXXX XXX XXX XXX X X XXXXXXXXX X XXXXX XXX X XXXXX X XXX X
X   X   X     X     X X X   X     X X X           X   X   X X     X       X   X X   X X X       X   X
X XXXXXXXXXXX XXXXX X X X XXX XXXXX X XXXXXXXXX XXXXX XXX XXXXXXX X XXXXXXXXX X XXX X X XXXXX XXX X X
X   X     X   X   X   X X   X X     X     X     X   X   X     X   X   X     X X     X X X   X X   X X
XXX X XXX X XXX X XXXXX XXX X X XXXXXXXXX XXX XXX X X X XXXXX X XXXXX X XXXXX X XXXXX X X X XXX XXX X
X   X   X   X   X           X X     X   X   X X   X X X X   X X X     X X     X   X   X   X     X   X
X XXX XXXXX X XXXXXXXXXXXXXXX XXX X X X XXX XXX XXX XXX XXX X XXX XXXXX X XXXXXXXXX XXXXXXXXXXXXX XXX
X   X X   X X     X   X     X   X X X X   X X   X X   X X   X     X     X X       X X           X   X
XXX XXX X XXXXXXX X X X XXX XXX X X X X XXX X XXX XXX X X X XXXXXXXXXXX X X XXXXX X XXXXXXX XXXXXXX X
X   X   X   X     X X X   X     X X X X     X   X       X X             X   X   X X X     X   X     X
X X X XXXXX X XXXXX XXXXX XXXXXXX X X XXXXXXXXX XXXXXXXXX X XXXXXXXXXXX XXXXX XXX X X XXX XXX X XXXXX
X X X X   X   X         X X     X X X X       X     X X   X X     X   X X   X   X X X   X   X   X   X
X XXX X XXXXXXX XXXXX X X X XXX X X X X X XXX XXXXX X X X XXX XXX X X X X X XXX X X XXX XXX XXX XXX X
X X   X     X   X     X X   X   X X X X X X X     X X X X     X   X X X   X     X X   X X X   X     X
X X XXXXX XXX XXX XXXXXXXXXXX XXXXX X XXX X XXXXX X X X XXXXXXX XXX X XXXXX XXXXX X XXX X XXX XXXXX X
X X     X       X   X       X X     X   X X     X X X   X     X   X X     X X     X   X   X   X   X X
X XXXXX XXXXXXXXXXX X X XXX X XXX XXXXX X X XXX X X X XXX XXX XXX X XXXXX X X XXXXX X XXX X XXX XXX X
X   X   X   X       X X       X   X     X X   X X X X   X   X   X X X   X X X X     X     X X       X
X X X XXX X X XXXXXXX X XXXXXXX XXX XXXXX XXX XXX X XXX XXXXXXX X X XXX X XXX XXXXXXXXXXXXX X XXXXXXX
X X       X X       X X X     X           X   X   X X           X   X   X   X   X     X     X       X
X XXXXXXXXX XXXXXXX X XXX XXX XXXXXXXXXXXXX XXX XXX XXXXXXXXXXX XXXXX XXXXX XXX X XXX X XXXXXXXXXXX X
X X     X                   X       X   X         X   X     X   X         X   X X   X   X         X X
XXX XXX XXXXXXXXXXX XXXXXXX XXXXXXX X X X XXXXXXX XXX X XXX X XXXXXXXXX X X XXX XXX XXXXXXXXX XXXXX X
X   X X   X       X X   X   X   X   X X X   X   X     X X X   X   X   X X X     X   X     X   X     X
X XXX XXX XXXXXXX X X X XXXXX X X XXX X XXXXX X XXXXXXX X XXXXX X X X XXX XXXXXXX XXX XXX X XXX XXXXX
X   X   X X     X   X X       X   X         X X   X X   X     X X X X         X     X   X   X   X   X
XXX X XXX X XXX XXX X XXXXXXXXXXX X XXXXXXX X XXX X X XXXXX X X X X XXXXXXXXX XXX X XXX XXXXX XXX X X
X   X     X X     X X X   X     X X     X X   X X X X     X X   X X     X   X   X X   X X     X   X X
X XXXXX XXX XXXXX XXX X X X XXX X XXXXX X XXXXX X X XXXXX X XXXXX XXXXX X XXXXX XXXXX X X XXXXX XXX X
X     X X       X X   X X X X   X X X   X X       X X     X     X       X     X     X X   X     X   X
XXXXX X XXXXXXX X X XXXXX X X XXX X X XXX X XXXXXXX X XXXXXXXXX XXXXXXXXX X X XXXXX X X XXX XXXXX XXX
X     X   X     X X X     X X       X X   X   X         X       X   X     X X X   X X X         X   X
X XXXXXXX X XXX X X X X XXX XXXXXXXXX X XXXXX XXXXXXXXX X XXXXXXX X XXXXXXX X XXX X X XXXXXXX X XXX X
X     X     X   X   X X     X X     X X     X   X     X   X       X     X   X     X X   X   X X X   X
X XXX XXXXXXX X XXXXX XXXXXXX X XXX X X XXX XXX X XXX XXXXX XXXXX XXXXX X XXXXXXX X XXX X XXX X X XXX
X X X   X   X X       X       X X   X X   X X   X   X     X     X X       X X     X     X     X X   X
X X XXX X X XXXXX XXXXXXX X XXX X XXX XXXXX X XXXXX XXXXX XXXXX X XXXXXXXXX X XXXXXXXXXXX XXXXX XXX X
X   X X   X     X       X X X   X   X     X         X   X X     X X   X     X X X         X X   X   X
XXX X XXXXX XXX XXXXXXX XXX X XXXXX XXXXX XXXXXXXXXXX X X XXXXXXX X X XXX X X X X XXXXXXXXX X X X X X
X X   X   X X X X     X     X X   X X   X     X     X X X       X   X   X X   X X X         X X   X X
X X XXX X X X X X XXXXX XXXXX X XXX X X XXXXX X XXX XXX XXXXXXX X XXXXX X XXXXX X XXXXX X X X XXXXX X
X   X   X X   X X       X   X X     X X X     X   X     X     X X     X X X     X     X X X X     X X
XXXXX XXX X XXX X XXXXXXX X X XXXXX X X X XXXXXXX X XXXXX X XXX XXXXX X X XXXXX XXXXX X X XXXXXXX X X
X     X X X   X X       X X   X   X   X   X       X X     X   X     X X X   X   X X   X X       X   X
X XXXXX X X X X XXXXXXX X XXXXX X XXXXXXXXX X XXXXX X XXXXXXX XXXXX X X XXX X X X X XXXXX X XXX XXXXX
X X     X X X   X     X X X     X   X     X X     X X   X   X   X   X X   X   X X X     X X X X X   X
X XXXXX X X XXXXX X XXX X X XXXXXXX X X XXX XXXXX XXXXX X X XXX X XXX XXX XXXXX X X XXX XXX X X X X X
X   X   X   X   X X     X   X   X X X X     X   X X     X X   X X X   X   X     X   X   X   X X   X X
X X X XXXXX X X XXXXXXXXXXX X X X X X XXXXXXX X X X XXXXXXX XXX X XXX X XXXXX XXXXX X XXX XXX XXXXX X
X X X       X X           X X X X X X         X X X         X   X   X X X   X       X X   X X       X
XXX X XXXXXXX XXX XXXXXXX X X X X X XXXXXXXXXXX X X XXXXXXX X X XXX XXX X X XXXXXXXXX X X X X XXXXXXX
X   X       X   X X   X X X   X   X X   X       X X   X     X X X   X   X X       X   X X X X X     X
X XXXXXXXXX XXX XXX X X X XXXXXXXXX X X XXXXX XXX X X X XXXXX X X XXX XXX XXXXXXX X XXXXX X X X XXX X
X X   X   X   X     X X     X       X X X       X   X     X   X X X X     X     X   X     X   X   X X
X X X X XXX XXXXXXXXX XXXXX X X XXXXX X X XXXXX XXXXXXXXXXX XXX X X X XXXXX XXX XXXXX XXXXXXX X XXX X
X X X X     X       X     X   X X     X   X     X   X       X X X       X     X X   X       X X X   X
X X X X XXXXX X XXX XXXXX XXXXX X XXXXXXXXX XXXXX X X XXXXXXX X X XXXXX X XXX X X X X XXXXX X XXX X X
X X X X X     X X   X   X X X   X X         X     X   X X       X     X X   X X X X X X X   X   X X X
X X X XXX XXXXX X XXX X X X X XXX X XXXXXXXXX X XXXXXXX X XXXXXXXXXXX X XXX X X X XXX X X XXXXX X XXX
X X X     X     X X X X   X     X X   X     X X X     X   X         X X X   X X X       X   X   X   X
X X XXXXXXX XXXXX X X XXXXXXXXX X XXX X XXX X X XXX XXX XXX XXX XXXXX X X XXX X XXXXXXXXXXX X XXXXX X
X X       X X   X X X X     X   X X   X X   X X   X       X X X       X X   X X     X       X     X X
X XXXXXXX X X XXX X X X XXX XXXXX X XXX XXX XXXXX XXXXXXXXX X XXXXX XXX XXXXX XXXXX X XXXXXXXXXXX X X
X X       X X       X   X X   X   X X X   X       X       X X       X       X X   X   X       X   X X
X X XXXXXXX XXXXXXX XXXXX XXX X XXXXX X X XXX XXXXX XXXXX X X XXXXX XXXXXXX X X XXXXXXX XXXXX X XXX X
X         X X     X   X   X X   X   X   X X   X       X   X   X   X       X   X             X X     X
X XXXXXXXXX X XXX XXX X X X XXXXX XXX XXX XXXXX XXXXXXX X XXXXX XXXXXXXXX XXXXX XXXXXXXXXXX XXXXXXX X
X   X       X   X X X   X   X         X X       X   X   X   X           X   X   X         X       X X
XXX X X XXXXXXX X X XXX XXXXX XXXXXXXXX XXXXXXXXX X X XXXXXXX XXXXXXXXX XXX X XXXXXXX XXX XXXXXXX X X
X X X X X       X X   X X     X               X   X X X   X   X       X   X X   X   X   X X     X   X
X X X XXX XXXXXXX X X X X XXXXXXXXXXXXX XXXXX X XXX X X X X XXXXXXX X X XXX XXX X X XXX X X XXX XXXXX
X X X     X     X X X X X X   X       X X   X X X X X X X X X       X X   X   X   X   X X     X     X
X X XXXXXXX XXX X XXX X X X X X XXXXX X X XXX X X X X X X X X XXXXXXX XXX XXX XXXXXXX XXXXXXXXXXXXX X
X X X   X   X X X   X   X X X X X X   X X   X     X X   X X   X     X X   X   X     X             X X
X X X X XXX X X XXX XXXXX X X X X X XXX X X XXXXX X XXX X XXXXX X XXX X XXX XXX XXX XXXXXXXXXXXXX X X
X     X           X         X   X       X X             X       X     X     X     X                 K
XXXXXXXXXXXXXXXXXXXXXXXXXXXXXXXXXXXXXXXXXXXXXXXXXXXXXXXXXXXXXXXXXXXXXXXXXXXXXXXXXXXXXXXXXXXXXXXXXXXXX
